1111111111111111
1000000000000001
1000000000000001
1000000000000001
1000000000000001
1000000100000001
1000100000000001
1000000100000001
1000000000000001
1000000000000001
1000100001100001
1000000000000001
1000000000000001
1000000011100001
1000000000000001
1111111111111111.
