1111111111111111
1001000000000001
1001000000000001
1001000000000001
1001011111111101
1001010000000001
1001010000000001
1001011111111101
1001000010000001
1001000010000001
1001111110000001
1011000000000001
1000000000000001
1001111111111111
1000000000000001
1111111111111111.
